11111111111111111111
1E0010C0000100100001
10001110000100100001
1P000000000100100001
10000000000100100001
100C0000000100100001
11111111111111111111